R 1920 1080

NO ./textures/greystone.xpm
SO ./textures/purplestone.xpm
WE ./textures/redbrick.xpm
EA ./textures/wood.xpm

S ./textures/creeper.xpm
F 77,92,53
C 163,208,230

		1111111111111111111111111
		10000000001100S0000000001
		1011000001110000002000001
		1001000000000000000002001
111111111011000001110000000000001
100000000011000001110111110111111
11110111111111011100000010001
11110111111111011101010010001
11000000110101011100000010001
10002000000000001100000010001
10000000000000001101010010001
110000011101010111110111100111
111101111110101101111010001
111111111111111111111111111