NO ./textures/greystone.xpm    
SO ./textures/purplestone.xpm
WE ./textures/redbrick.xpm

EA ./textures/wood.xpm
S ./textures/creeper.xpm
F 111,92,53
C 163,208,230

11111111111111111111111111
1N0000000001101111111111111111
10110000011100000020000001111111
10010000000000000000020011111111
111111111011000001110000011111111111
10000000001100000111011111111111111
11110111111111011100000111
1110111111111011S101011111111
11000000110101011100000011
10002000000000001100000011
10000000000000001101010011
11000001110101011111011111
11110111111010110111101001
1111111111111111111111111111