NO ./textures/greystone.xpm
SO ./textures/purplestone.xpm
WE ./textures/redbrick.xpm
EA ./textures/wood.xpm
S ./textures/creeper.xpm
F 77,92,53
C 163,208,230

1111111111111111111111111
1000000000110000000000001
1011000001110000002000001
1001000000000000000002001
11111111101100000111011111111111
10000000001100000111011111111111
11110111111111011100000011
11110111111111011101111111111
1100000011010101110000111111111
100020000000000011000000111111111
10000000000011110N111111111111
111101111110101101111010001
111111111111111111111111111