NO ./textures/greystone.xpm   
SO ./textures/purplestone.xpm
WE ./textures/redbrick.xpm

EA ./textures/wood.xpm
S ./textures/creeper.xpm
F 111,92,53
C 163,208,230

11111111111111111111111111
1000000000110111111111111111          
10110000011100000020000001111111
10010000000000000000020011111111
111111111011000001110000011111111111
10000000110000011101111111111111
11110111111111011100000111
1110111111111011101011111111
110000001101010N11100000011
10002000000000001100000011
10000000000000001101010011
11000001110101011111011111
11110111111011111111111
1111111111111111111111111111